You just woke up. The sunlight peeks through your window as you lie in your bed.

Welcome
An Interactive Fiction
Release 1 / Serial number 251001 / Inform 7 v10.1.2 / D

BedroomTwo
Your bedroom. A dresser full of clothes is neatly arranged.

You can see a dresser-two (in which is a pile-of-clothes) here.

>go north
You can't go that way.

I beg your pardon?

I beg your pardon?